10 10
S 0 0
P 2 2 8 8
P 3 3 7 7
1 1 1 1 1 1 1 1 1 1
1 2 2 1 1 1 1 1 1 1
1 2 X 1 1 1 1 1 1 1
1 1 1 1 3 3 1 1 1 1
1 1 1 1 3 3 1 1 1 1
1 1 1 1 1 1 1 1 1 1
1 1 1 1 1 1 1 1 1 1
1 1 1 1 1 1 1 1 1 1
1 1 1 1 1 1 1 1 1 1