5 5
S 0 0
P 1 1 3 3
P 2 2 4 4
1 1 1 1 1
1 2 2 1 1
1 2 X 1 1
1 1 1 1 3
1 1 1 3 3